NO images/512.xpm
SO images/ciel.xpm
WE images/miroirs_roses.xpm
EA images/miroirs_violet.xpm

F 200,120,40
C 214,10,252

1111    11111
1001111110001
1110000000S01
  1000000p001
1110000000001
1000000011111
111111111   1