NO images/512.xpm
SO images/miroirs_roses.xpm
WE images/ciel.xpm
EA images/miroirs_roses.xpm

F5 238,130,0
C 255,30,0

        111111111111111111111111
        1000000000110000000000001
        1011000001110000000000001
        1001000000000000000000001
111111111011000001110000000000001
100000000011000001110111111111111
11110111111111011100000010001
11110111111111011101010010001
11000000110101011100000010001
10000000000000001100000000001
10000000000000000001010000001
1100000111010101111101110S00111
11110111 1110101 101111000001
11111111 1111111 111111111111