NO ./path_to_the_north_texture.xpm
SO ./path_to_the_south_texture.xpm
WE ./path_to_the_west_texture.xpm
EA ./path_to_the_east_texture.xpm

F 220,100,0
C 225,30,0

        11111111111111111111111111
        1000000000110010000000001
        1011000001110000000000001
        1001000000000000000000001
111111111011000001110000000000001
100000000011000001110111111111111
111101111111110111000000100000001
111101111111110111010100100011001
11000000110101011100000010001111
100000000000000011000001000111
1000000000000000110101001N001
11000001110101001111011110001
11110111 1110101 101111010001
11111111 1111111 111111111111