NO images/512.xpm
SO images/ciel.xpm
WE images/miroirs_roses.xpm
EA images/miroirs_violet.xpm

F 220,100,0
C 225,30,54

        1111111111111111111111111
11000000110101011100000010001
10000000000000000110000010001
10000000000W00001101010010001
110000011101010111110111100111
11110111 1110101 101111010001
11111111 1111111 111111111111
1111111111111111111111111