NO images/512.xpm
SO images/ciel.xpm
WE images/miroirs_roses.xpm
EA images/miroirs_violet.xpm

F 255,182,193
C 46,85,46

111111111111111111111111111111111111111111111111111111111
100000000000N00000000000000000000000000000000000000000001
101111111001100110011111100110011100011001111110011111101
101000000001100110011000000110011110011001100000000011001
101111111001111110011111100110011011011001111110000110001
100000001001100110011000000110011001111001100000001100001
101111111001100110011111100110011000111001111110011111101
100000000000000000000000000000000000000000000000000000001
111111111111111111111111111111111111111111111111111111111