NO images/512.xpm
SO images/ciel.xpm
WE images/miroirs_roses.xpm
EA images/miroirs_violet.xpm

F 198,65,222
C 18,56,178

        1111111111111111111111111
        1000000000000000000000001
        10110S0001111110000000001
        1001000000001001000000001
111111111011000001111110000000001
        111111111111111111111111